



							SO ./textures/south.xpm
WE						 ./textures/west.xpm

C 				229,           107, 111
EA ./textures/east.xpm

F 100, 89, 124
NO 														./textures/north.xpm
111111111111111111111111111111
100000000000100010000000000101
100000000 0000000000000000001
11000000 N 0000000000000010111
100000000 0000100000010000001
11000000000000000000000000011
100000000000000000000000000001
100000000000001000100111111111
1000000011110000001111111 1111
1111111111111111111111111 1111
