NO ./textures/north.xpm
SO ./textures/south.xpm
WE ./textures/west.xpm
EA ./textures/east.xpm

F 109, 89, 122
C 229, 107, 111

111111111111111111111
1000000000000000000E1
111111111111111111111
