SO ./textures/north.xpm
NO ./textures/south.xpm
WE ./textures/west.xpm
EA ./textures/east.xpm

F 109,89, 122
C 100, 107, 1113

11111
10001
10101
10001
10001
10E01
11001
10001
10001
10001
10001
10001
11111
