NO ./textures/north.xpm
SO ./textures/south.xpm
WE ./textures/west.xpm
EA ./textures/east.xpm

F 109, 89, 122
C 229, 107, 111

11111
10001
10S01
10001
10001
10001
11001
10001
10001
10001
10001
10001
11011
